A,C,G,T,nonAmb,code
5594,3835,2125,5428,16982,Neotetracus_sinensis_NC_019626
5691,4009,2232,5328,17260,Neomys_fodiens_KM092492
3318,1982,1198,3258,9756,Neohylomys_hainanensis_MVZ186403
5874,3315,2008,5645,16842,Mesechinus_hughi_KT824773
3737,2735,1507,3957,11936,Hylomys_suillus_tionis_MZUM4F
5576,3999,2172,5540,17287,Hylomys_suillus_suillus_T1773
4918,3295,1926,5169,15308,Hylomys_suillus_siamensis_T1346
4834,3191,1854,5082,14961,Hylomys_suillus_siamensis_T1264
2172,1304,832,2277,6585,Hylomys_suillus_peguensis_USNM583813
4867,3225,1883,5153,15128,Hylomys_suillus_microtinus_T1084
4911,3302,1920,5166,15299,Hylomys_suillus_microtinus_MHNG1926.032
4958,3361,1901,5133,15353,Hylomys_suillus_maxi_T0675
4959,3358,1902,5134,15353,Hylomys_suillus_maxi_RHN38347
4949,3350,1894,5117,15310,Hylomys_suillus_maxi_MZUM5B
5498,3745,2130,5594,16967,Hylomys_suillus_dorsalis_BOR655
5482,3722,2114,5570,16888,Hylomys_suillus_dorsalis_BOR635
5498,3737,2127,5579,16941,Hylomys_suillus_dorsalis_BOR627
5498,3730,2128,5593,16949,Hylomys_suillus_dorsalis_BOR620
5503,3750,2131,5581,16965,Hylomys_suillus_dorsalis_BOR351
5345,3632,2076,5471,16524,Hylomys_suillus_dorsalis_BOR342
2578,1842,1064,2612,8096,Hylomys_suillus_dorsalis_BOR312
2080,1466,896,2034,6476,Hylomys_suillus_dorsalis_BOR309
2026,1402,860,1928,6216,Hylomys_suillus_dorsalis_BOR168
5312,3787,2044,5189,16332,Hylomys_parvus_MZB15912
6086,3313,2028,5856,17283,Hemiechinus_auritus_NC_005033
5937,3503,2185,5822,17447,Erinaceus_europaeus_NC_002080
5735,3583,2095,5515,16928,Erinaceus_amurensis_KX964606
5997,3549,2094,5447,17087,Echinosorex_gymnura_AF348079
