A,C,G,T,nonAmb,code
0,0,0,0,0,ZRC45046
0,0,0,0,0,ZRC45042
0,0,0,0,0,ZRC45049
0,0,0,0,0,ZRC45051
22,15,17,10,64,USNM124229
487,323,191,451,1452,USNM320495
2246,1512,829,2374,6961,THNHM03942
1938,1385,765,2124,6212,THNHM03952
2987,2101,1249,3051,9388,USNM320500
5234,3703,2172,5317,16426,USNM320490
5212,3570,2081,5452,16315,USNM321535
5499,3776,2083,5410,16768,USNM271034
5270,3731,2187,5352,16540,USNM320485
5546,3761,2142,5727,17176,ANSP20372
5457,3701,2184,5765,17107,USNM300009
5644,3864,2132,5548,17188,ANSP20377
5388,3618,2107,5658,16771,USNM260640
5410,3659,2123,5723,16915,USNM355443
